* Comments can be placed on these asterisk separator lines
* End of the file should be %
* Bricks are 1, space is 0
* The level leght should be no more than 18 characters long
* The level height should be no more than 6 characters long
* You can write maps by yourself
* Level 1
000000000000000000
000000000000000000
111111111111111111
000000000000000000
000000000000000000
000000000000000000
* Level 2
000000000000000000
000000000000000000
111111111111111111
111111111111111111
000000000000000000
000000000000000000
* Level 3
100000000000000001
111000000000000011
111110000000011111
111111100001111111
000000000000000000
000000000000000000
* Level 4
010101010010101010
101010101101010101
111111111111111111
101010101101010101
000000000000000000
000000000000000000
* Level 5
000000000000000000
001111111111111100
001000000000000100
001001111111100100
001000000000000100
001111111111111100
* Level 6
111111111111111111
111111111111111111
110011001100110011
110011001100110011
111111111111111111
000000000000000000
%