* Comments can be placed on these asterisk separator lines
* End of the file should be %
* Bricks are 1, space is 0
* The level leght should be no more than 18 characters long
* The level height should be no more than 6 characters long
* You can write maps by yourself
* Level 1
110000000000000011
111110001100011111
001111111111110000
000000001100000000
000001110001110000
000011000000011000
* Level 2
000000000000000000
000000011111111111
111111111110000000
000000011111111111
111111111110000000
000000000000000000
* Level 3
111111111111111111
011111111111111110
001011001100110100
001010001100010100
001000000000000100
000000000000000000
* Level 4
000011010010110000
000110010010011000
001100010010001100
111000010010000111
111111110011111111
000000000000000000
* Level 5
111111110011111111
000000011110000000
111111100001111111
000000111111000000
111111000000111111
000000000000000000
%